  #######  
  #. V .#  
###     ###
#. . . . .#
#         #
#I . M . O#
#         #
#. . . . .#
###     ###
  #. ^ .#  
  #######  
