###########      
#. . . . .#      
#         #      
#. . . . .#      
#         ###    
#. . . . .+.#    
#         # #    
#. . . . .#.#    
#         # ### #
#. . . . .#. . .#
#################
