                                     
                                     
                    #####            
                    #E .#             
                    ### ###          
                      #. .#          
                      ### ###         
                        #.#P#                
                        # # ###              
                        #.|.#.#              
                        ### # #              
                        #.#.#.#              
                      ### # # ###            
                      #. .#.#. .#            
                    ### # # ### #            
                    #. .#.#.#. .#            
            ######### ### # # ###            
            #. . . . . . . .#. .#            
          ### # ##### # #   ### #            
          #. .#.#. . .#.#. . . .#            
        ### ### #   ### ### # ###            
        #. . . . . .#. . . .#.#              
        # ### * *** # # ##### #              
        #.#.#.*, ,*.#.#. . . .#              
        # # # *   * # # ### ###              
        #. . .*U G*. .#.#. .#                
        ###   ***** #########              
          #. . . . . . . .#                  
          ### # # ##### ###                  
            #.#.#. . . .#                    
            # # # #######                    
            #. .#. .#                        
            #########                        
