            #########               
            #. . . .#                
        ##### # ### #                
        #. . .#.#. .#                 
      ### ##### # #####              
      #. . . . . . . .#               
    ### # ### *****   ###             
    #. .#.#. .*H V*. . .#                    
  ### ### ### *   * ### #                    
  #. .#. . . .*, ,*.#. .#                    
  # # # ##### *** * #   #                    
  #.#. . . .#. . L .#. .#                    
##### ##### ######### ###                    
#. . . . . .#. . . . .#                      
# ### ####### ##### ###                      
#.#. . . . . . . .#.#                        
# # ####### #########                        
#.#. . . . .#                                
# ####### ###                                
#. . .#. .#                                  
### # # ###                                  
  #.#. .#                                    
  # #####                                    
  #. . .#                                    
  ### # #                                    
    #.#.#                                    
    ### ###                                  
      #. .#                                  
      ### ###                                
        #. D#                                
        #####                                
                                             
